10 x 20
*********O**********
*  R        r      *
*   R +  *  *      *
*        H  *      *
*   **     *   *   *
*   *      *  +    *
*     + +    R  *  *
*  *           **  *
*     R      *     O
*O******************